XXXXXXXXXXXXXXXXXXXXXXXX
XM                     X
XXXXXXXXXXXXXXXXXXXXXX X
XX                     X
X  X XXXX XXXXXXXXXXXX X
X XX X    XG           X
X X    XX XXXXXXXXXXXX X
X XXXXXX  XXXXX        X
X         X    X XXXXX X
X XXXXXX XXXXXXX    X  X
X  X             X   X X
XXXXXXXXX XXXXXXXXX XXXX
X                      X
X XXXXXXXXXXXXXXXXXXXX X
X        P             X
XXXXXXXXXXXXXXXXXXXXXXXX
