XXXXXXXXXXXXXXXXXXXXXXXX
X             M        X
X XXXXXXXXXXXXXXXXXXXXXX
X                      X
XXXXXXXXXXXXXXX XXXXXXXX
X                      X
XXXXXXXXXXXXXXX XX XXXXX
X  G            X      X
X               XXXXXX X
XXXXXXXXX XXXXX X   X  X
X       X       X X    X
X XXXXX XXXXXXX XXXXXX X
X               X      X
X XXXXXXXXXXXXXXXX XXXXX
X                     PX
XXXXXXXXXXXXXXXXXXXXXXXX
