XXXXXXXXXXXXXXXXXXXXXXXX
X                      X
XXXXXX XXXXXXXXXXXXXXX X
XX               M  G  X
X  X XXXX XXXXXXXXXXXXXX
X XX X                 X
X X    XX XXXXXXXXXXXX X
X XXXXXX  XXXXX        X
X     X S X    X XXXXX X
X XX XXX XXXX XX    X  X
X  X             X   X X
X XXXXXXX XXXXXXXXX XXXX
X    X                 X
X XXX  XXXXXXXXXXXXXXX X
X        P             X
XXXXXXXXXXXXXXXXXXXXXXXX
