XXXXXXXXXXXXXXXXXXXXXXXX
X                      X
XXXXXXXXXXXXXXXXXXXXXXXX
XPX                XXXXX
X XXXXXXXXXXXXXXX     XX
XS                 XXX X
X XXXXXXXXX XXXXXXXXXX X
X XXXXXXXX             X
X X       X    XXXXXXX X
X XXXXXX XXXXXXX    X  X
X X X            X   X X
X X  XXXXXXXXXXXXXX XX X
X X                    X
X   XXXXXXXXXXXXXXXXXXXX
XG                   M X
XXXXXXXXXXXXXXXXXXXXXXXX
