XXXXXXXXXXXXXXXXXXXXXXXX
X                      X
XXXXXXXXXXXXXXXXXXXXXXXX
X                  XXXXX
X MXXXXXXXXXXXXXXX     X
X                  XXX X
X XXXXXXXXXXXXXXXXXXXX X
XXXXXXXXXX             X
X         X    XXXXXXX X
X XXXXXX XXXXXXX    X  X
X   X            X   X X
XXX  XXXXXXXXXXXXXX XX X
X   S                  X
XXXXXXXXXXX XXXXXXXXXXXX
XP                    GX
XXXXXXXXXXXXXXXXXXXXXXXX
