XXXXXXXXXXXXXXXXXXXXXXXX
XM                     X
X XXXXXXXXXXXXXXXXXXXX X
X                      X
X XXXXXXXXXXXXXXXXXXXX X
X XXXXXXXXXXXXXXXXXXXX X
X XXXXXXXXXXXXXXXXXXXX X
X                      X
X              X XXXXX X
X XXXXXXX XXXXXX     X X
X                    X X
X XXXXXXXXXXXXXXXXXXXX X
X  XG                  X
X XXXXXXXXXXXXXXXXXXXX X
X                     PX
XXXXXXXXXXXXXXXXXXXXXXXX
