XXXXXXXXXXXXXXXXXXXXXXXX
XM                     X
XXXXXXXXXXXXXXXXXXXXXX X
XX                     X
X  X XXXX XXXXXXXXXXXX X
X XX X    XG           X
X X    XX XXXXXXXXXXXX X
X XXXXXX  XXXXX        X
XX        X    X XXXXX X
X XXXXXX XXXXXXX    X  X
X  X             X   X X
X XXXXXXX XXXXXXXXXXXX X
X  X      X            X
X XXXXXXX XXXXXXXXXXXXXX
X                     PX
XXXXXXXXXXXXXXXXXXXXXXXX
