XXXXXXXXXXXXXXXXXXXXXXXX
XM                     X
X XXXXXXXXXXXXXXXXXXXX X
X         G            X
X XXXXXXXXXXXXXXXXXXXXXX
X XXXXXXXXXXXXXXXXXXXX X
X XXXXXXXXXXXXXXXXXXXX X
X XXXXXXXXXXXXX        X
X              X XXXXX X
X XXXXXXX XXXXXX     X X
X                    X X
X XXXXXXXXXXXXXXXXXXXX X
X  X                   X
X XXXXXXXXXXXXXXXXXXXX X
X                    XPX
XXXXXXXXXXXXXXXXXXXXXXXX
