XXXXXXXXXXXXXXXXXXXXXXXX
X                      X
XXXXXXXXXXXXXXXXXXXXXXXX
X X                  X X
X XXXXXXXXXXXXXXXXXXXX X
X XXX              XXX X
X XXXXXXXXXPXXXXXXXXXX X
X XXXXXXXX S           X
X          X           X
X XXX      X        XX X
X X       XXX       XX X
X XXX XXXXXXXXXXX XXXX X
X          G           X
XXXXXXXXXXX  XXXXXXXXXXX
X        M             X
XXXXXXXXXXXXXXXXXXXXXXXX
