XXXXXXXXXXXXXXXXXXXXXXXX
XM                     X
X XXXXXXXXXXXXXXXXXXXX X
X         G            X
X XXXXXXXXXXXXXXXXXXXX X
X XXXXXXXXXXXXXXXXXXXX X
X XXXXXXXXXXXXXXXXXXXX X
X XXXXXXXXXXXXX        X
XS             X XXXXX X
X XXXXXXX XXXXXX     X X
X                    X X
X XXXXXXXXXXXXXXXXXXXX X
X  X                   X
X XXXXXXXXXXXXXXXXXXXX X
X                     PX
XXXXXXXXXXXXXXXXXXXXXXXX
