XXXXXXXXXXXXXXXXXXXXXXXX
X                      X
XXXXXXXXXXXXXXXXXXXXXX X
X                      X
X XXXXXXXXXXXXXXXXXXXXXX
X                      X
XXXXXXXXXXXXXXXXXXXXXX X
X                      X
X              X XXXXXXX
XXXXXXXXXXXXXXXX       X
X                      X
X  XXXXXX XXXXXXXXXXXXXX
X  X                   X
X XXXXXXXXXXXXXXXXXXXXXX
X                      X
XXXXXXXXXXXXXXXXXXXXXXXX